18 19
00 00 00 00 00 00 00 00 00 00 00 00 00 00 00 00 00 00 00 
00 00 00 00 00 00 00 00 00 10 00 00 00 00 00 00 00 00 00 
00 00 00 00 00 00 00 00 10 00 00 10 20 10 00 00 00 00 00 
00 00 00 00 00 00 00 00 00 00 00 00 00 00 00 00 00 00 00 
00 00 00 00 00 00 05 00 00 03 00 20 00 10 00 00 00 00 00 
00 00 00 10 10 00 00 00 00 00 00 00 00 20 10 00 00 00 00 
00 01 00 04 00 00 00 00 20 00 00 00 00 20 00 00 00 00 00 
00 00 00 10 00 00 05 00 10 00 00 03 00 10 00 20 10 00 00 
00 00 00 00 00 00 10 00 10 10 10 00 20 00 00 00 00 00 02 
00 02 00 00 00 00 00 00 00 10 00 00 00 00 00 10 20 00 00 
00 00 00 00 00 10 00 00 00 00 00 00 10 20 10 10 10 00 00 
00 02 00 00 10 00 10 10 00 00 03 00 10 00 00 00 00 00 00 
00 00 00 00 04 20 00 00 00 00 00 00 00 20 00 04 10 00 10 
00 10 10 20 10 10 10 00 10 00 10 00 20 10 10 00 10 00 00 
00 00 20 20 10 05 10 20 01 20 30 10 00 00 10 00 10 10 00 
00 00 00 20 10 20 10 00 00 00 10 10 00 20 20 10 20 00 00 
00 00 00 00 00 30 00 00 20 00 10 10 00 10 00 00 00 00 00 
00 00 00 00 00 00 10 00 20 10 00 00 10 00 00 00 00 00 00 
hamwas 1 56
asgwef 2 44
sfdghae 3 11
fdghf 4 86
BlueAI 5 23
asdjh 6 99
sdhygd 7 42
